11111111111
1CC1111E1P0
11111111111