1111111111111111
10000P00000001
10001000C00001
10001100100001
1000E11C1C0001
11111111111111
